0 0 0 0 0 0 0 0 0 0 0 0 0 0 0 0 0 0 0 0 0 0 0 0 0 0 0 0 0 0 0 0 0 0 0 0 0 0 0 0
0 0 8 9 9 9 9 8 9 9 9 9 8 9 9 9 9 8 9 9 9 9 8 9 9 9 9 8 9 9 9 9 8 9 9 9 9 8 0 0
0 0 10 16 16 16 16 10 16 16 16 16 16 16 16 16 16 16 16 16 16 16 16 16 16 16 16 16 16 16 16 16 16 16 16 16 16 10 0 0
0 0 10 16 24 25 16 10 16 0 0 0 0 0 0 0 0 0 0 0 0 0 0 0 0 0 0 0 0 0 0 0 0 0 0 0 16 10 0 0
0 0 10 16 26 27 16 10 16 0 0 0 0 0 0 0 0 0 0 0 0 0 0 0 0 0 34 33 35 0 0 0 0 0 0 2 16 10 0 0
0 0 10 16 0 0 16 10 16 0 0 0 0 0 0 0 0 0 0 2 0 0 0 34 33 33 33 33 33 33 35 0 0 0 0 0 16 10 0 0
0 0 8 16 0 0 16 8 16 0 0 0 0 0 0 0 0 0 0 0 0 0 34 33 33 33 33 33 33 33 33 0 0 0 0 0 16 8 0 0
0 0 10 16 0 0 16 16 16 0 0 0 0 0 0 0 0 0 0 0 0 34 33 33 33 33 33 33 33 33 33 35 0 0 0 0 16 10 0 0
0 0 10 16 0 0 0 0 0 0 0 0 0 0 2 0 0 0 0 0 0 33 33 33 33 33 33 33 33 33 33 33 35 0 0 0 16 10 0 0
0 0 10 16 0 0 0 0 0 0 0 0 0 0 0 0 0 0 0 0 0 36 33 33 33 33 33 33 33 33 33 33 33 0 0 0 16 10 0 0
0 0 10 16 16 16 16 16 16 16 16 16 16 16 0 0 0 0 0 0 0 0 0 36 33 33 33 33 33 33 33 33 33 0 0 0 16 10 0 0
0 0 8 9 9 9 9 8 9 9 9 9 8 16 0 0 0 0 0 0 0 0 0 0 0 0 36 33 33 33 33 33 33 0 0 0 16 8 0 0
0 0 10 16 16 16 16 16 16 16 16 16 10 16 0 0 0 0 0 0 0 2 0 0 0 0 0 0 36 33 33 33 37 0 0 0 16 10 0 0
0 0 10 16 0 0 0 0 0 0 0 16 10 16 0 0 0 0 0 0 0 0 0 0 0 0 0 0 0 0 0 0 0 0 0 0 16 10 0 0
0 0 10 16 0 0 3 0 0 0 0 16 10 16 0 0 0 0 0 0 0 0 0 0 0 0 0 0 0 0 0 0 0 0 0 0 16 10 0 0
0 0 10 16 0 0 0 0 0 0 0 16 10 16 0 1 0 0 18 17 17 17 19 0 0 0 0 18 17 19 0 0 0 0 0 0 16 10 0 0
0 0 8 16 0 0 0 0 0 0 0 16 8 16 0 0 0 0 17 17 17 17 17 19 0 18 17 17 17 21 0 0 0 2 0 0 16 8 0 0
0 0 10 16 0 0 0 0 0 0 0 16 10 16 0 0 0 0 20 17 17 17 17 17 17 17 17 17 21 0 0 0 0 0 0 0 16 10 0 0
0 0 10 16 0 0 0 0 3 0 0 16 10 16 0 0 0 0 18 17 17 17 17 17 17 17 17 21 0 0 0 0 0 0 0 0 16 10 0 0
0 0 10 16 0 0 0 0 0 0 0 16 10 16 0 18 17 17 17 17 17 17 17 17 21 0 0 0 0 0 0 34 33 35 0 0 16 10 0 0
0 0 10 16 0 3 0 0 0 0 0 16 10 16 18 17 17 17 17 17 17 21 0 0 0 0 0 0 0 0 34 33 33 33 35 0 16 10 0 0
0 0 8 16 0 0 0 0 0 0 18 17 8 17 17 17 17 21 0 0 0 0 0 0 0 0 0 0 0 34 33 33 33 33 33 35 16 8 0 0
0 0 10 16 0 0 0 0 0 0 17 17 17 17 17 21 0 0 0 0 0 0 2 0 0 0 0 0 34 33 33 33 33 33 33 37 16 10 0 0
0 0 10 16 0 0 0 0 0 0 20 17 17 21 0 0 0 0 0 0 0 0 0 0 0 0 0 0 36 33 33 33 33 37 0 0 16 10 0 0
0 0 10 16 0 0 0 0 0 0 0 0 0 0 0 0 0 0 0 0 0 0 0 0 0 0 0 0 0 0 0 0 0 0 0 0 16 10 0 0
0 0 10 16 16 16 16 16 16 16 16 16 16 16 16 16 16 16 16 16 16 16 16 16 16 16 16 16 16 16 16 16 16 16 16 16 16 10 0 0
0 0 8 9 9 9 9 8 9 9 9 9 8 9 9 9 9 8 9 9 9 9 8 9 9 9 9 8 9 9 9 9 8 9 9 9 9 8 0 0
0 0 0 0 0 0 0 0 0 0 0 0 0 0 0 0 0 0 0 0 0 0 0 0 0 0 0 0 0 0 0 0 0 0 0 0 0 0 0 0
