14 14 14 14 14 14 14 14 14 14 14 14 14 14 14 14 14 14 14 14 14 14 14 14 14 14 14 14 14 14 14 14 14 14 14 14 14 14 14 14
14 16 16 16 16 16 16 16 16 16 16 16 16 16 16 16 16 16 16 16 16 16 16 16 16 16 16 16 16 16 16 16 16 16 16 16 16 16 16 14
14 16 0 0 0 0 0 0 2 0 0 0 0 0 0 0 0 0 0 0 0 0 0 0 0 0 0 0 0 0 0 0 0 0 0 0 0 0 16 14
14 16 0 0 0 0 0 0 0 0 0 0 0 0 0 0 0 0 0 0 0 0 0 0 0 0 0 0 3 0 0 0 0 0 0 0 0 0 16 14
14 16 0 0 0 0 0 0 0 0 0 0 0 0 0 0 0 0 0 0 0 0 0 0 0 0 0 0 0 0 0 0 0 0 0 0 0 0 16 14
14 16 16 16 16 16 16 16 16 16 16 16 16 16 0 0 0 0 0 2 0 0 0 0 0 0 0 0 0 0 0 0 0 0 0 0 2 0 16 14
9 8 9 9 9 9 9 8 9 9 9 9 8 16 0 0 0 0 0 0 0 0 0 0 0 0 0 0 0 0 0 0 0 0 0 0 0 0 16 14
14 16 16 16 16 16 16 16 16 16 16 16 10 16 0 0 0 0 0 0 0 0 0 0 0 0 0 0 0 0 0 0 34 33 35 0 0 0 16 14
14 16 0 0 0 0 0 0 0 24 25 16 10 16 0 0 0 0 0 0 0 0 0 0 0 0 0 0 0 0 0 34 33 33 33 35 0 0 16 14
14 16 0 0 0 0 0 0 0 26 27 16 10 16 0 0 0 0 0 0 0 0 0 0 0 0 0 0 0 0 34 33 33 33 33 37 0 0 16 14
14 16 0 0 0 0 16 16 16 16 16 16 10 16 0 0 0 0 0 0 0 0 0 0 0 0 0 0 0 34 33 33 33 33 33 0 0 0 16 14
14 16 0 0 0 0 16 8 9 9 9 9 8 16 0 0 0 0 0 0 0 0 0 0 0 0 0 0 0 33 33 33 33 33 37 0 0 0 16 14
14 16 0 0 0 0 16 16 16 16 16 16 16 16 0 0 0 0 0 0 0 2 0 0 0 0 0 0 0 36 33 33 37 0 0 0 0 0 16 14
14 16 0 0 0 0 0 0 0 0 0 0 0 0 0 0 0 0 0 0 0 0 0 0 0 0 0 0 0 0 0 0 0 0 0 0 0 0 16 14
14 16 0 0 0 0 0 0 0 0 0 0 0 0 0 0 0 0 0 0 0 0 0 0 0 0 0 0 0 0 0 0 0 0 0 0 0 0 16 14
14 16 0 0 0 0 0 0 0 0 0 0 0 0 0 1 0 0 0 0 0 16 16 16 16 16 16 16 16 16 16 16 16 16 0 0 16 16 16 14
14 16 0 0 0 0 0 0 0 0 0 0 34 33 35 0 0 0 0 0 0 16 8 9 9 9 9 8 9 9 9 9 8 16 0 0 16 8 9 9
14 16 0 0 0 0 0 0 0 0 34 33 33 33 33 35 0 0 0 0 0 16 10 16 16 16 16 16 16 16 16 16 16 16 0 0 16 10 14 14
14 16 0 0 0 0 0 0 34 33 33 33 33 33 33 33 0 0 0 0 0 16 10 16 0 0 0 0 0 0 0 0 0 0 0 0 16 10 14 16
14 16 0 0 0 0 0 34 33 33 33 33 33 33 33 33 35 0 0 0 0 16 10 16 0 0 0 0 0 0 0 0 0 0 0 0 16 10 14 16
14 16 0 0 0 0 0 33 33 33 33 33 33 33 33 33 33 0 0 0 0 16 10 16 0 0 0 3 0 0 0 0 0 0 0 0 16 10 14 16
14 16 0 0 2 0 0 36 33 37 0 0 36 33 33 33 37 0 0 0 0 16 8 16 0 0 0 0 0 0 0 0 0 0 0 0 16 8 14 16
14 16 0 0 0 0 0 0 0 0 0 0 0 0 0 0 0 0 0 0 0 18 13 17 17 19 0 0 0 0 0 0 0 0 0 0 16 10 14 16
14 16 0 0 0 0 0 0 0 0 0 0 0 0 0 0 0 0 0 18 17 17 13 17 17 17 0 0 0 0 0 0 0 0 0 0 16 10 14 16
14 16 0 0 0 0 0 3 0 0 0 0 0 0 0 0 0 0 0 17 17 17 13 17 17 21 0 0 0 0 0 0 0 0 0 2 16 10 14 16
14 16 0 0 0 0 0 0 0 0 0 0 0 0 0 0 16 16 16 20 17 17 13 17 21 16 16 16 16 16 16 16 16 16 16 16 16 10 14 16
14 16 16 16 16 16 16 16 16 16 16 16 16 16 16 16 16 8 9 9 9 9 8 9 9 9 9 8 9 9 9 9 8 9 9 9 9 8 14 16
14 14 14 14 14 14 14 14 14 14 14 14 14 14 14 14 14 10 14 14 14 14 14 14 14 14 14 14 14 14 14 14 14 14 14 14 14 14 14 16
